#####################
#...................#
#.........BW...A.F..#
#......C.PPPPPPPPPPP#
#.H....PP...........#
#PPP................#
#PPPPPPP............#
#.......PPPPPPPPPP..#
#...................#
#...................#
#..PPPPPPPPPPEEEEEPP#
#M..................#
#PPPPPPP............#
#.......PPPPPP......#
#PPPP...........PPPP#
#............L.PPPPP#
#PPPPPPPPPPPPPPPPPPP#
#####################