#####################
#...................#
#..............BW...#
#......C.PPPPPPPPPPP#
#.S....PP...........#
#PPP.N..............#
#PPPPPPP...C...C....#
#G......PPPPPPPPPP..#
#...................#
#...................#
#...................#
#M.C...GL....G...C..#
#..PPPQQQPPPEEEPPPPP#
#....C..............#
#PPPPPPP............#
#.A.....PPPPPP...S..#
#PPPP...........PPPP#
#.F............PPPPP#
#PPPPPPPPPPPPPPPPPPP#
#####################