#####################
#...................#
#..M...........BW...#
#......C.PPPPPPPPPPP#
#.H....PP...........#
#PPP.N..............#
#PPPPPPP...C...C...P#
#.......PPPPPPPPPP..#
#...................#
#...................#
#...................#
#..L..S.............#
#..PPPEEEEEEEEEEPPPP#
#....C..............#
#PPPPPPP............#
#.A.....PPPPPP...S..#
#PPPP...........PPPP#
#.F............PPPPP#
#PPPPPPPPPPPPPPPPPPP#
#####################