#####################
#...................#
#..............A.F..#
#........PPPPPPPPPPP#
#......PP...........#
#PPP................#
#PPPPPPP....C.......#
#.......PPPPPPPPPP..#
#...................#
#......S............#
#..PPPPPPPPPPPPPPPPP#
#M..................#
#PPPPPPP............#
#.W.....PPPPPP....S.#
#PPPP...........PPPP#
#.B......L.....PPPPP#
#PPPPPPPPPPPPPPPPPPP#
#####################