#####################
#...................#
#........WB....A.F..#
#........PPPPPPPPPPP#
#......PP...........#
#PPP................#
#PPPPPPP....C.......#
#.......PPPPPPPPPP..#
#...................#
#......S............#
#..PPPPPPPPPPPPPPPPP#
#M..................#
#PPPPPPP............#
#.......PPPPPP....S.#
#PPPP...........PPPP#
#........L.....PPPPP#
#PPPPPPPPPPPPPPPPPPP#
#####################