#####################
#...................#
#..............A.F..#
#........PPPPPPPPPPP#
#......PP...........#
#PPP................#
#PPPPPPP....C.......#
#.......PPPPPPPPPP..#
#...................#
#......S............#
#..PPPPPPPPPPPPPPPPP#
#...................#
#PPPPPPP............#
#.W.....PPPPPP......#
#PPPP...........PPPP#
#.B......LHM...PPPPP#
#PPPPPPPPPPPPPPPPPPP#
#####################