#####################
#...................#
#.........B....A.F..#
#........PPPPPPPPPPP#
#......PP...........#
#PPP................#
#PPPPPPP....C.......#
#.......PPPPPPPPPP..#
#...................#
#......S............#
#..PPPPPPPPPPEEEEEPP#
#M..................#
#PPPPPPP............#
#.......PPPPPP....S.#
#PPPP...........PPPP#
#..W.....L.....PPPPP#
#PPPPPPPPPPPPPPPPPPP#
#####################