#####################
#F...............A..#
#PP.............PP..#
#.....R.............#
#..PPPP.......PKKP.G#
#G.................S#
#Q..........EEEEEEEP#
#QQP................#
#...................#
#....C...M...C......#
#..PPPPPPPPPPPPP....#
#...................#
#PPPPQQQ.....EEEPPPP#
#.........G.........#
#........PPP........#
#.BW....PPPPP.......#
#PPPPPPPPPPPPPPPPPPP#
#####################
