#####################
#...................#
#.........BW...A.F..#
#......C.PPPPPPPPPPP#
#.HN...PP...........#
#PPP................#
#PPPPPPP.......I....#
#.......PPPPPPPPPP..#
#...................#
#...................#
#..PPPPPPPPPPEEEEEPP#
#M..................#
#PPPPPPP............#
#.......PPPPPP......#
#PPPP...........PPPP#
#............L.PPPPP#
#PPPPPPPPPPPPPPPPPPP#
#####################