#####################
#F...............A..#
#PP.............PP..#
#.....L.............#
#..PPPP.......PKKP..#
#..................S#
#Q..........EEEEEEEP#
#QQP................#
#...................#
#....C...M...CR.....#
#..PPPPPPPPPPPPP....#
#...................#
#PPPPQQQ.....EEEPPPP#
#...................#
#........PPP........#
#.BW....PPPPP.......#
#PPPPPPPPPPPPPPPPPPP#
#####################
