#####################
#...................#
#.........BW...A.F..#
#........PPPPPPPPPPP#
#.H....PP...........#
#PPP................#
#PPPPPPP....C.......#
#.......PPPPPPPPPP..#
#...................#
#......S............#
#..PPPPPPPPPPEEEEEPP#
#M..................#
#PPPPPPP............#
#.......PPPPPP....S.#
#PPPP...........PPPP#
#........L.....PPPPP#
#PPPPPPPPPPPPPPPPPPP#
#####################