#####################
#..............A.F..#
#........PPPPPPPPPPP#
#......PP...........#
#PPP................#
#PPPPPPP............#
#.......PPPPPPPPPP..#
#...................#
#...................#
#..PPPPPPPPPPPPPPPPP#
#...................#
#PPPPPPP............#
#.W.....PPPPPP......#
#PPPP...............#
#.B............PPPPP#
#PPPPPPPPPPPPPPPPPPP#