#####################
#.........WB...A.F..#
#........PPPPPPPPPPP#
#......PP...........#
#PPP................#
#PPPPPPP............#
#.......PPPPPPPPPP..#
#...................#
#...................#
#..PPPPPPPPPPPPPPPPP#
#...................#
#PPPPPPP............#
#.......PPPPPP......#
#PPPP...............#
#..............PPPPP#
#PPPPPPPPPPPPPPPPPPP#