#####################
#.........BW...A.F..#
#........PPPPPPPPPPP#
#......PP...........#
#PPP................#
#PPPPPPP............#
#.......PPPPPPPPPP..#
#...................#
#...................#
#..PPPPPPPPPPPPPPPPP#
#...................#
#PPPPPPP............#
#.......PPPPPP.....P#
#PPPP...........PPPP#
#..............PPPPP#
#PPPPPPPPPPPPPPPPPPP#