#####################
#...................#
#W.................B#
#QQQ............EEEE#
#...................#
#...................#
#....KKKKPPKKKK.....#
#....P........QQC...#
#....P.........QPQP.#
#....PPPPPPPPPPPPPP.#
#......R............#
#.....EEE.....QQQQQQ#
#.....C......M......#
#EEEEEPPPPPPPPPPPP..#
#...................#
#..............P....#
#...S.......S..P....#
#...PKPPKPP.PPKPPPPP#
#.A......P.......F..#
#PPPPPPPPPPPPPPPPPPP#
#####################