#####################
#...................#
#B.................W#
#QQQ............EEEE#
#...................#
#...................#
#....KKKKPPKKKK.....#
#....P........QQC...#
#....P.........QQQQ.#
#....PPPPPPPP.PP....#
#......R.........H..#
#.....EEE.....QQQQQQ#
#.....C......M......#
#EEEEEPPPPPPPPPPPP..#
#...................#
#..............P....#
#..............P....#
#...S..........P....#
#...PKPPKPP.PPKPPPPP#
#.A......P.......F..#
#PPPPPPPPPPPPPPPPPPP#
#####################
